100 100
50 0
1000000000011000000011111000000011111111110011111000100111111111100111111111001111100010001111100010
1000000000011000010010001000010010001000000010001000000100010000000100010000001000100000001000100000
1000011100011111110000001111110010001000010010001000100100010000100100010001001000100010001000100010
1000011100011000010011111000010010001000010010001000100100010000100100010001001000100010001000100010
1000000000011000000010001000000000001000010000001000100000010000100000010001000000100010000000100010
1000001000011000010010001000010010001000010010001000100100010000100100010001001000100010001000100010
1000011100011000010010001000010011111111110011111111100111111111100111111111001111111110001111111110
1010111110011000010000001000010010001000010010001000100100010000100100010000001000100010001000100010
1000111110011111110010001111110010001000000010001000000100010000000100010000001000100000001000100000
1000011101111000010011111000010000001000010000001000100000010000100000010001000000100010000000100010
1000001001111000000010001000000010001000010010001000100000010000100100010001001000100010001000100010
1000000000011000010010001000010011111111110011111111100111111111100111111111001111111110001111111110
1000011000011000010010001000010010001000010010001000100100010000100100010000001000100010001000100010
1000011000011000010000001000010010001000000010001000000100010000000100010000001000100000001000100000
1000000000011111110010001111110000001000010000001000100000010000100000010001000000100010000000100010
1000000000011000010011111000010010001000010010001000100000010000100100010001001000100010001000100010
1000000000011000000010001000000011111111110011111111100111111111100111111111001111111110001111111110
1000000000011000010010001000010010001000010010001000100100010000100100010000001000100010001000100010
1000000000011000010010001000010010001000000010001000000100010000000100010000001000100000001000100000
1000000000011000010000001000010000001000010000001000100000010000100000010001000000100010000000100010
1000000000011111110010001111110010001000010010001000100000010000100100010001001000100010001000100010
1000000000011000010011111000010011111111110011111111100111111111100111111111001111111110001111111110
1000000001111000000010001000000010001000010010001000100100010000100100010000001000100010001000100010
1000000001111000010010001000010010001000000010001000000100010000000100010000001000100000001000100000
1000010000011000010000001000010000001000010000001000100000010000100000010000000000100010000000100010
1000000000011000010010001000010010001000010010001000100000010000100100010000001000100010001000100010
1000111000011111110011111111110011111111110011111111100111111111100111111111001111111111001111111110
1001111100011000000000000000000000000000000000000000000000000000000000000000000000000000000000000000
1101111101011000000000000000000000000000000000000000000000000000000000000000000000000000000000000000
1001111100011000000000000000000000000000000000000000000000000000000000000000000000000000000000000000
1000111000011000000000000000000000000000000011111111111111111110000000000000000000000000000000000000
1000000000011000000000000000000000000000000011111111111111111110000000000000000000000000000000000000
1000010000011000000000000111110111111111011110000000000000000010000000000000000000000000000000000000
1000000001111000000000000100010000010001000010000000000000000010000000000000000000000000000000000000
1000000001111000000000000100010000010001010010000000000000000010000000000000000000000000000000000000
1000000000011000000000000100010100010001010010000000000000000010000000000000000000000000000000000000
1000000000011000000000000100000100010000010010000000000000000010000000000000000000000000000000000000
1000000000011000000000000100000100010000011110000000000000000010000000000000000000000000000000000000
1000000000011000000000000111110111111111000010000000000000000010000000000000000000000000000000000000
1000000000011000000000000100010000010001000010000000000000000010000000000000000000000000000000000000
1000000000011000000000000100010000010001010010000000000000000010000000000000000000000000000000000000
1000000000011000000000000100010100010001010011111001111111000010000000000000000000000000000000000000
1000000000011000000000000100000100010000010010000000000001000010000000000000000000000000000000000000
1000000000011000000000000100000100010000010010000000000001111110000000000000000000000000000000000000
1000000000011111111100000111111111111111111110111111111100000010000000000000000000000000000000000000
1000000000000111111100000111111111111111111110111111111100000011111111111111111111111111111111111111
0000000000000000000000000000000000000000000000111111111100000000000000000000000000000000000010000000
0000000000000000000000000000000000000000000000111111111100000000000000000000000000000000000010000000
0000000000000000000000000000000000000000000000111111111111111111110000000000000000000000000010000000
0000000000000000000000000000000000000000000000111111111111111111110000000000000000000000000010000000
0000000000000000000000000000000000000000000000111111111111111111110000000000000000000000000010000000
0000000000000000000000000000000000000000000000111111111111111111110000000000000000000000000000000000
0000000000000000000000000000000000000000000000111111111111111111110000000000000000000000000000000000
0000000000000000000000000000000000000000000000111111111111111111110000000000000000000000000010000000
0000000000000000000000000000000000000000000000111111111100000000000000000000000000000000000010000000
0000000000000000000000000000000000000000000000111111111100000000000000000000000000000000000010000000
0000000000000000000000000000000000000000000000111111111100000000000000000000000000000000000010000000
0000000000000111111100000111111111111111111110111111111100000011111111111111111111111111111111111111
1000000000011111111100000111111111111111111110000000000000000010000000000000000000000000000000000000
1000000000011000000000000000000000000000000010000000000000000010000000000000000000000000000000000000
1000000000011000000000000000000000000000000010000000000000000010000000000000000000000000000000000000
1010000000011000000000000000000000000000000010000000000000000010000000000000000000000000000000000000
1000000000011000000001111111111111111111111111111111111111111110000000000000000000000000000000000000
1000000001011000000001111111111111111111111111111111111111111110000000000000000000000000000000000000
1000000000011000000000000000000000000000000000000000000000000000000000000000000000000000000000000000
1000000000011000000000000000000000000000000000000000000000000000000000000000000000000000000000000000
1000011000011000000000000000000000000000000000000000000000000000000000000000000000000000000000000000
1000111100011000000000000000000000000000000000000000000000000000000000000000000000000000000000000000
1001111110011000000000000000000000000000000000000000000000000000000000000000000000000000000000000000
1001111110011000000000000000000000000000000000000000000000000000000000000000000000000000000000000000
1000111100011000000000000000000000000000000000000000000000000000000000000000000000000000000000000000
1000011000011000000000000000000000000000000000000000000000000000000000000000000000000000000000000000
1000000010011000000000000000000000000000000000000000000000000000000000000000000000000000000000000000
1010000000011000000000000000000000000000000000000000000000000000000000000000000000000000000000000000
1000000000011000000000000000000000000000000000000000000000000000000000000000000000000000000000000000
1000000000011110011111111111110011111111111111100111111111111111100011111111111100111111111100011111
1000000000011110011111111111110011111111111111100111111111111111100011111111111100111111111100011111
1000000000011000000000000000000000000000000000000000000000000000000000000000000000000000000000000000
1000000000011000000000000000000000000000000000000000000000000000000000000000000000000000000000000000
1000000000011000000000000000000000000000000000000000000000000000000000000000000000000000000000000000
1000000000011111101111111111001111111111001111111110011111111100111111111001111111110011111111101111
1000100010011000000000100000000000100000000000100000000001000000000010000000000100000000001000000000
1000000000011000000000100000000000100000000000100000000001000000000010000000000100000000001000000000
1000000000011000000000100000000000100000000000100000000001000000000010000000000100000000001000000000
1000110000011000000000100000000000100000000000100000000001000000000010000000000100000000001000000000
1001111000011111101111111111001111111111001111111110011111111100111111111001111111110011111111101111
1001111010011000000000100000000000100000000000100000000001000000000010000000000100000000001000000000
1000110000011000000000100000000000100000000000100000000001000000000010000000000100000000001000000000
1000000000011000000000100000000000100000000000100000000001000000000010000000000100000000001000000000
1000000000011000000000100000000000100000000000100000000001000000000010000000000100000000001000000000
1000000000011111101111111111001111111111001111111110011111111100111111111001111111110011111111101111
1011000000011000000000100000000000100000000000100000000001000000000010000000000100000000001000000000
1000001000011000000000100000000000100000000000100000000001000000000010000000000100000000001000000000
1000000000011000000000100000000000100000000000100000000001000000000010000000000100000000001000000000
1000000000011000000000100000000000100000000000100000000001000000000010000000000100000000001000000000
1000000000011111101111111111001111111111001111111110011111111100111111111001111111110011111111101111
1000000010011000000000100000000000100000000000100000000001000000000010000000000100000000001000000000
1000000000011000000000100000000000100000000000100000000001000000000010000000000100000000001000000000
1000000000011000000000100000000000100000000000100000000001000000000010000000000100000000001000000000
1000000000011000000000100000000000100000000000100000000001000000000010000000000100000000001000000000
