100 100
0000000000001000000100000000000000000000000000000000000000000000000000000000000000000000000000000000
0000000000001000000100000000000000000000000001111111111111111111111100000000100000000000000000000000
1101000000001000000110000000000000000000000000000000000000000000000000000000011100000000000000000000
0000000001001000000000000000000000000000000000001000000001000000000000000000011100000000000000000000
0001000000001001011000000110000001101101110000000000000000000111111000000000011100000000000000000000
0000000000000000011000000000001101101000000010000000000000000111111000000000000001110000000000000000
0000000000000000000000000000000000001000000010000000000000000000000111110000000001110000000000000000
0000110010011100000001111000010000001001000000000001000000000100000111110000000000000000000000000000
0000010010011100111111111011000010001001000000000000100000000001111100000000000000000000000000000000
1010010010000000111111111011111000000001000000000000100000000000000000000000000000000000000000000000
0000110010000000000000000001111000000001000010000000010110000001000000000110000000000000000000000000
0000111110000000001000000001011111011111110011111110001000011111100000100110000000000000000000000000
0010011110000100000100000010000110011111110000000000000000000000000000100010000001100000000000000000
0000110010000000000000000010000110100011010000010000000000000000011000000000100001100000000000000000
0000110110000000000000000000000111100011110000000000000000000000000000000000100000100000000000000000
0000010000000000000000000000000111111000000000000000000100000000000000000000000001100000000000000000
0000011110000001000000000000000001111000000000111111100001111100000000000000000000100000000000000000
0000110110000001100000000000000111011000000000000000000000000000000000000000000001100000000000000000
0000110110000001100000100100000110000000000000000000000000000000000001110000000001100000000000000000
0000000000000000000000100100000111111000000000000000000000001000011111110110001110000000000000000000
0000001000000000000000000100000001111000000111000000000000111000010011000110000010000000000000000000
0100000100000000000111100100000111111000000000000000000000111000010011000000001110000000000000000000
0000000000000000100111100100000000000000000000000000000000000000011011000000001000000000000000000000
0000000000000000000000000111110010000000010000001110000010000000000000000100001000000000000000000000
0000000000000000000000000000000000000000000000001110000000000000000000001000001110000000000000000000
0000000000000000000000000000000000000001000000001000000000000000000000000000001110000000000000000000
0000001111111011111111111000000000001100000000001110000000000000000000000000001110000000000000000000
0000000000011011100000111000000000000000000000001110000000000100000000000000000000000000000000000000
0100001111111011111100111000000000000000011111100000000000000010000100000000000001110000000000000000
0000001100000011111110000000000000000001000000000000001111000000000100000000000001110000000000000000
0001101100000011110000000000000000100000001000000000000000000111100100000000000000000000000000000000
0001101111111111111110001000001000000000001110000000000000000111100100000000000000000000000000000000
0001101111111110111110000000001000000000001110000000000000000000000100000000000000000000000000000000
0000000000000000000000000000000000011110111111111111111111111000000100001100000000000000000000000000
0000000000000000000000000000000000011110111110000000000000011000000000000001110001000000000000000000
0000000000010000000000000000000000000000111110000000000000000000000000000001110001000000000000000000
0000010000010000011000000000110100011110111111111111111111111010000000100001110001000000000000000000
0001000000010000011000000000000001100000000000000000100000000100000000100000000000000000000000000000
0000000000000000011000000000000010000000000000111000100000000001000000100000011000100000000000000000
1000000000001000011000000000000000000000000000111000100111100000000000000000011000000000000000000000
1000000000001000011111111111000000000100001100111000000111100000000000000000011000000000000000000000
0000000000000010000000000000000000000100001100001111111100101000000010000000000000000000000000000000
0000000000000010000000000000000000000000001100001111111100001000000000000000000000000000000000000000
0000000100000000000000000000000001110000010100001110011100000000110000000000000000000000000000000000
0000000001000000000000000000000001110000010000000000111000000000110000000000000000000000000000000000
0000000000000000000000000000000000000000010000000000111100000000000000111111001100000000000000000000
0000100000000000000000000000000000000000100000000000001111111000000000111111001100000000000000000000
0010000000000000000000100100001110000011100000000000000011100000000000000000001100000000000000000000
0000000000000000111100000000001110000011100001000000000011111000000000000000001100000000000000000000
0000000000001100111100000000001110001100000000000000000010000000000000011000000000000000000000000000
0000000000001100000000000000000000001100000000000000000010000000011000011000000000000000000000000000
0000000000000000000000000000000000001100000000000000000010000000011000011000000000000000000000000000
0000100000000000000100000000001100001100111111001111000011111000011000000000100000000000000000000000
0000100000000000011110000000001100001100111001100000000000001111011000000100100000000000000000000000
0000000000000000011110000000011100001100111001100000000000001000000000000100000000000000000000000000
0000000000010000011110000001111100001100000001100000000000001000000000000011000001000000000000000000
0000000000000000000000000001111100001100000000001110000000001000110000000011000001000000000000000000
0000000000000000010000000011111100001100000000000000000000001000000000000000100000000000000000000000
0000000000000000000000111111111100010000000001001111000001001000000000100000000000000000000000000000
0000011000000000000000111111111100000000000000001111000000001000000000000000000000000000000000000000
0000011100001110111000111100001100000000011100000001111111101000000000000000000000000000000000000000
0011000000001110111000100110000000011110011100000001111111101000000000010000000000000000000000000000
0000000100001100111000000110000000000000000000001111000000000000100000010000000010100000000000000000
0000000000001111100000000110000000000000000000000000000001111111111000010000100000100000000000000000
0000000000001110000000000000000000000000000000000010000000000000011000010000100000100000000000000000
0000001100000011111000000000000000000000000010000010000000000000011000000000000000000000000000000000
0000001100001110111000100000001110111100000000000000010000000000000000000000000000000000000000000000
0000011100001110111000000000001110111100000001000000000000000000000000000000100000000000000000000000
0000001100000000000000000000000001111100110001000111000000000000000000000000100000000000000000000000
0000000000000000000000000000000000000000100000000011000000000100100100000000100000000000000000000000
1000000000000000000000000000000011111000100000000011000000000000100000000000100000000000000000000000
0000000011110000000000000000000011110000000000100011000011010000000000000000100000000000000000000000
0110000011110000001110000000000011110000000000100011010000000000000000000000100000000000000000000000
0110000011100011001110000000000000000000010000000111000011000000010000000010000000000000000000000000
0011000011000000000000000001000000000000000000000000000001000000010000000000000000000000000000000000
0011000011110000100001011100000000000000000000011111000000000000000000000000110000100000000000000000
0000110011110000101000000111100000000001000000000000000000000000001111110000000000000000000000000000
0000110000000000000000000111100000000000011000000000000000000011101100000000000000000000000000000000
0000000000000000000000001111100000000000000000000001110000000011101101110000000000000000000000000000
0000000000000000000000000000000000000000000010000101110000000011101101110000000000000000000000000000
0110000100000000000000110000000000000000000000000000000000000000000000000000000000000000000000000000
0110000010000011100000110000000011000000000000010000001110000000011000000000000100000000000000000000
0110000000000000000000000000000001010000000000000000000001110000011000000000110100000000000000000000
0110000001000011110000000000101111110001111000000000010000010000000000000000000100000000000000000000
0001110000000011110000000001001110111111111000000010000000000111100011001000010100000000000000000000
0001110000000011110000000000001100111110011001100010000000000111100011000000000001111000000000000000
0001000000000011110000000000001100000000000000000000000000001111100000000000000001111000000000000000
0001110000000000000000000000001100000000000011100000000000000000000000000000000000000000000000000000
0001110000000000000000000000000000000000000000000000001110000000000111000100000000000000000000000000
0000001100000000000011111111110000000000000000000000001110000000000111000000000000000000000000000000
0000001000001000000011110001110000000000000000000000000100000001000001001000000000000000000000000000
0000001100000000000011111001110000000000000000000000001110000000000000001000001000111100000000000000
0000001100000000000000000000000000000000000000000000001110000000000000000010000000111100000000000000
0000000010000000000000000000000000111100000000000011100011111000000000000001100000000000000000000000
0000100011111110100000000000000000000000000000000011100011000001111110000000001000000000000000000000
0011000001111000000000000000000000000000100000000010000011000001111110000000001000000000000000000000
0010000001000000000000000100000000000000000000000010000010000000000000010000000000000000000000000000
0010000001110000000000000001111000000000000000000011100011000000000000000000000010000000000000000000
0000000001100000000000000001111000000000000000000011100011000000000000000000000000000000000000000000
0000000001111000011100000000000000000000000000000011100000100000000000000000000000000000000000000000
