100 100
0 99
0000000000000000000000000000000000000000000000000000000000000000000000000000000000000000000000000000
0000000000000000000000000000000000000000000000000000000000000000000000000000000000000000000000000000
0000000000000000000000000000000000000000000000000000000000000000000000000000000000000000000000000000
0000000000000000000000000000000000000000000000000000000000000000000000000000000000000000000000000000
0000000000000000000000000000000000000000000000000000000000000000000000000000000000000000000000000000
0000000000000000000000000000000000000000000000000000000000000000000000000000000000000000000000000000
0000000000000000000000000000000000000000000000000000000000000000000000000000000000000000000000000000
0000000000000000000000000000000000000000000000000000000000000000000000000000000000000000000000000000
0000000000000000000000000000000000000000000000000000000000000000000000000000000000000000000000000000
0000011111111111011111000111011111111111111111111111111111111111111111111101111000111111101111111100
0000011111111111011111000100000000011111111111111111100000000000010000000000001000100000000001000100
0000011111111111011111000100000000010000000000000001100000000000010000000000001000100000000001000100
0000011111110000000001000100000000010000000000000001100000000000010000000000001000100000000000000100
0000010000010000000001000100000000010000000000000001100000000000010000000000001000100000000001000100
0000010000010000000001000100000000010000000000000001100000000000010000000000001000100000000001000100
0000010000010000000001000110011111110000000000000001100000000000011111111100111000111111110011111100
0000010000010000000001000110010000010000000000000001100000000000011100000100111000100000010010000100
0000000000010000000001000110010000010000000000000001100000000000011100000100111000100000010010000100
0000010000010000000001000110000000010000000000000001100000000000011100000000111000000000000000000100
0000010000010000000001000110010000010000000000000001100000000000011100000100111000100000010010000100
0000010000010000000001000110010000010000000000000001100000000000011100000100111000100000010010000100
0000010000011100111111000110011111111111101111111111111111101111111111111100111000111111110011111100
0000010000011100100001000110000000000000000000000000000000000000000000000000111000100000010010000100
0000010000011100100001000110000000000000000000000000000000000000000000000000111000100000010010000100
0000010000011100100001000111111111110111111111111101111111111111111011111111111000100000010010000100
0000010000011100100001000110000000000000000100000000000000000010000000000000001000100000010010000100
0000010000011100100001000110000000000000000100000000000000000010000000000000001000100000010010000100
0000010000011100100001000110000000000000000100000000000000000010000000000000001000100000000000000100
0000010000011100100001000110000000000000000100000000000000000010000000000000001000100000010010000100
0000010000011100100001000111111111111111111111111111111111111111111111111111111000100000010010000100
0000010000011100100001000000000000000000000000000000000000000000000000000000000000100000010010000100
0000010000011100000001000000000000000000000000000000000000000000000000000000000000100000010010000100
0000010000011100100001000000000000000000000000000000000000000000000000000000000000100000010010000100
0000010000011100100001000000000000000000000000000000000000000000000000000000000000100000010010000100
0000011111111100100001000000000000000000000000000000000000000000000000000000000000111111110011111100
0000011111111100100001000000000000000000000000000000000000000000000000000000000000100000010010000100
0000010000000100100001000000000000000000000000000000000000000000000000000000000000100000010010000100
0000010000000100100001000000000000000000000000000000000000000000000000000000000000100000010010000100
0000010000000100100001000000000000000000000000000000000000000000000000000000000000100000010010000100
0000010000000100100001000000000000000000000000000000000000000000000000000000000000100000010010000100
0000010000000100100001000000000000000000000000000000000000000000000000000000000000100000010010000100
0000000000000100100001000000000000000000000000000000000000000000000000000000000000100000010010000100
0000010000000100100001000000000000000000000000000000000000000000000000000000000000100000010010000100
0000010000000100100001000000000000000000000000000000000000000000000000000000000000100000010010000100
0000010000000100100001000000000000000000000000000000000000000000000000000000000000100000010010000100
0000010000000100100001000000000000000000000000000000000000000000000000000000000000100000010010000100
0000010000000100100001000000000000000000000000000000000000000000000000000000000000100000000000000100
0000010000000100111111000000000000000000000000000000000000000000000000000000000000100000010010000100
0000010000000100100001000000000000000000000000000000000000000000000000000000000000100000010010000100
0000010000000100100001000000000000000000000000000000000000000000000000000000000000100000010010000100
0000010000000100100001000000000000000000000000000111110000000000000000000000000000100000010010000100
0000010000000100100001000000000000000000000011111110110000000000000000000000000000100000010010000100
0000010000000100100001000000000000000000000111000000011110000000000000000000000000100000010010000100
0000010000000100100001000000000000000000001110000000000011110000000000000000000000100000010010000100
0000010000000100100001000000000000000000111100000000000000011100000000000000000000100000010010000100
0000010000000100000001000000000000000011100000000000000000011111000000000000000000100000010010000100
0000010000000100100001000000000000001110000000000000000000001111100000000000000000100000010010000100
0000011111111100100001000000000000011100000000000000000000000001111000000000000000100000010010000100
0000010000011100100001000000000000010000000000000000000000000001111100000000000000100000010010000100
0000010000011100100001000000000000000000000000000000000000000000000110000000000000111111110011111100
0000010000011100100001000000000000000000000000000000000000000000000000000000000000100000010010000100
0000010000011100100001000000000000000000000000000000000000000000000000000000000000100000010010000100
0000010000011100100001000000000000000000000000000000000000000000000000000000000000100000010010000100
0000010000011100111111000000000000000000000000000000000000000000000000000000000000100000010010000100
0000010000011100111111000000000000000000000000000000000000000000000000000000000000100000010010000100
0000010000011100100001000000000000000000000000000000000000000000000000000000000000100000010010000100
0000010000011100100001000000000000000000000000000000000000000000000000000000000000100000010010000100
0000010000011100100001000000000000000000000000000000000000000000000000000000000000100000010010000100
0000010000011100100001000000000000000000000000000000000000000000000000000000000000100000010010000100
0000010000011100100001000000000000000000000000000000000000000000000000000000000000100000010010000100
0000010000011100100001000000000000000000000000000000000000000000000000000000000000100000010010000100
0000010000011100100001000000000000000000000000000000000000000000000000000000000000100000010010000100
0000010000011100100001000000000000000000000000000000000000000000000000000000000000100000010010000100
0000010000011100100001000000000000000000000000000000000000000000000000000000000000100000010010000100
0000011101111100100001000000000000000000000000000000000000000000000000000000000000100000010010000100
0000010000010100100001000111111111111111111111111110111111111111111111111111111000100000010010000100
0000010000010100100001000100000000000000000000001000001000000000000000000000001000100000000000000100
0000010000010100100001000100000000000000000000001000001000000000000000000000001000100000010010000100
0000010000010100100001000100000000000000000000001000001000000000000000000000001000100000010010000100
0000010000010100100001000100000000000000000000001000001000000000000000000000001000100000010010000100
0000000000000100100001000100000000000000000000001000001000000000000000000000001000100000010010000100
0000010000010100000001000100000000000000000000001000001000000000000000000000001000100000010010000100
0000010000010100100001000111111111110111111111111000001111111111110111111111111000100000010010000100
0000010000010100100001000100000000000000000000000000000000000000000000000000001000100000010010000100
0000010000010100100001000100000000000000000000000000000000000000000000000000001000100000010010000100
0000010000010100100001000111111111110111111111111110111111111111110111111111111000100000010010000100
0000011101110100100001000100000000000000000000011000000100000000000000000000011000100000010010000100
0000010000010100100001000100000000000000000000011000000100000000000000000000011000100000010010000100
0000010000010100100001000100000000000000000000011000000100000000000000000000011000100000010010000100
0000010000010100100001000100000000000000000000011000000100000000000000000000011000111111110011111100
0000010000010100100001000100000000000000000000011000000100000000000000000000011000100000000000000100
0000010000010100100001000100000000000000000000011000000100000000000000000000011000100000000000000100
0000011111111111111111000111111111111111111111111111111111111111111111111111111000111111111111111100
0000000000000000000000000000000000000000000000000000000000000000000000000000000000000000000000000000
0000000000000000000000000000000000000000000000000000000000000000000000000000000000000000000000000000
0000000000000000000000000000000000000000000000000000000000000000000000000000000000000000000000000000
0000000000000000000000000000000000000000000000000000000000000000000000000000000000000000000000000000
0000000000000000000000000000000000000000000000000000000000000000000000000000000000000000000000000000
0000000000000000000000000000000000000000000000000000000000000000000000000000000000000000000000000000
0000000000000000000000000000000000000000000000000000000000000000000000000000000000000000000000000000
